year,England,Northern Ireland,Scotland,Wales,Total
2015,0,0,2056,71,2127
2016,202,170,825,0,1197
2017,38,1159,3342,546,5085
2018,4948,753,10637,1351,17689
2019,2398,284,21636,4436,28754
2020,2287,835,2440,7540,13102
2021,808,400,3402,1076,5686
2022,2966,569,6333,8819,18687
2023,311,106,7078,1070,8565
2024,73,0,2189,0,2262
2025,3194,2835,26133,12380,44542